1,1,1,1,1,1,1,1,1,1,1
1,0,0,0,0,0,0,0,0,0,1
1,0,4,0,8,0,8,0,4,0,1
3,0,0,0,0,5,0,0,0,0,9
1,0,4,0,0,0,0,0,4,0,1
1,0,0,0,6,0,7,0,0,0,1
1,1,1,1,1,1,1,1,1,1,1