0,0,0,0,0,0,0
0,1,1,1,1,1,0
0,1,4,1,4,1,0
0,1,1,1,1,1,2
2,1,1,3,1,1,0
0,1,1,1,1,1,0
0,0,0,0,0,0,0