1,1,1,1,1,1,1,1,1
1,0,0,4,0,4,0,0,1
1,4,0,0,5,0,0,4,1
3,0,0,0,1,0,0,0,1
1,4,0,0,0,0,4,0,1
1,0,0,4,6,4,0,0,1
1,0,0,0,0,0,0,0,1
1,4,0,4,0,4,0,4,1
1,1,1,1,7,1,1,1,1