{
    "width": 18,
    "height": 18,
    "spawn": {"x": 8, "y": 14},
    "zoneName": "BORGIR",
    "tiles": [
        14,14,14,14,14,14,14,14,14,14,14,14,14,14,14,14,14,14,
        14,14,14,14,14,14,14,14,14,14,14,14,14,14,14,14,14,14,
        14,14,11,11,11,11,11,11,11,11,11,11,11,11,11,11,14,14,
        14,14,11,11,11,11,11,11,11,11,11,11,11,11,11,11,14,14,
        14,14,11,11,11,11,11,11,11,11,11,11,11,11,11,11,14,14,
        14,14,11,11,11,11,11,11,11,11,11,11,11,11,11,11,14,14,
        14,14,11,11,11,11,11,11,11,11,11,11,11,11,11,11,14,14,
        14,14,11,11,11,11,11,11,11,11,11,11,11,11,11,11,14,14,
        14,14,11,11,11,11,11,11,11,11,11,11,11,11,11,11,14,14,
        14,14,11,11,11,11,11,11,11,11,11,11,11,11,11,11,14,14,
        14,14,11,11,11,11,11,11,11,11,11,11,11,11,11,11,14,14,
        14,14,11,11,11,11,11,11,11,11,11,11,11,11,11,11,14,14,
        14,14,11,11,11,11,11,11,11,11,11,11,11,11,11,11,14,14,
        14,14,11,11,11,11,11,11,11,11,11,11,11,11,11,11,14,14,
        14,14,11,11,11,11,11,11,11,11,11,11,11,11,11,11,14,14,
        14,14,11,11,11,11,11,11,11,11,11,11,11,11,11,11,14,14,
        14,14,14,14,14,14,14,14,15,14,14,14,14,14,14,14,14,14,
        14,14,14,14,14,14,14,14,15,14,14,14,14,14,14,14,14,14
    ],
    "enemies": [
        {"id": "borgir_boss", "type": "Boss", "x": 8, "y": 4, "hp": 50, "damage": 0, "sightRange": 0, "behavior": ["IDLE"], "adjacencyBark": "[Boss: You! Delivery boy! Car still dead? The rat-people down the sewer ripped out your cataclysmic converter. Get it back or you're walking these burgers forever. Go examine the heap out front.]"}
    ],
    "items": [],
    "examinables": [
        {"id": "borgir_counter", "x": 8, "y": 2, "text": "[The Borgir counter. Grease an inch thick. A hand-lettered sign: NO YELLOW CARD, NO TAXI, NO EXCEPTIONS.]"}
    ],
    "transitions": [
        {"x": 8, "y": 16, "toMap": "town-map.json", "toX": 8, "toY": 8, "label": "[Back out to the street]"}
    ]
}
