{
    "width": 58,
    "height": 22,
    "spawn": {"x": 4, "y": 2},
    "zoneName": "CARNIVAL",
    "tiles": [
        31,31,31,31,30,30,31,31,31,31,31,31,31,31,31,31,31,31,31,31,31,31,31,31,31,31,31,31,31,31,31,31,31,31,31,31,31,31,31,31,31,31,31,31,31,31,31,31,31,31,31,31,31,31,31,31,31,31,
        31,31,31,31,30,30,31,31,31,31,31,31,31,31,31,31,31,31,31,31,31,31,31,31,31,31,31,31,31,31,31,31,31,31,31,31,31,31,31,31,31,31,31,31,31,31,31,31,31,31,31,31,31,31,31,31,31,31,
        31,31,30,30,30,30,30,30,30,30,30,30,30,30,30,30,33,33,30,30,30,30,30,30,30,30,30,30,30,30,30,30,30,30,30,30,30,30,30,30,30,30,32,32,30,30,30,30,30,30,30,30,30,30,30,30,31,31,
        31,31,30,30,30,30,30,30,30,30,30,30,30,30,30,30,33,33,30,30,30,30,30,30,30,30,30,30,30,30,30,30,30,30,30,30,30,30,30,30,30,30,32,32,30,30,30,30,30,30,30,30,30,30,30,30,31,31,
        31,31,30,30,30,30,30,30,30,30,30,30,30,30,30,30,30,30,30,30,31,31,31,31,30,30,30,30,30,30,30,30,30,30,30,30,30,30,30,30,30,30,30,30,30,30,30,30,30,30,30,30,30,30,30,30,31,31,
        31,31,30,30,30,30,30,30,30,30,30,30,30,30,30,30,30,30,30,30,31,31,31,31,30,30,30,30,30,30,30,30,30,30,30,30,30,30,30,30,30,30,30,30,30,30,30,30,30,30,30,30,30,30,30,30,31,31,
        31,31,30,30,32,32,30,30,30,30,30,30,30,30,30,30,30,30,30,30,31,31,31,31,30,30,30,30,30,30,33,33,30,30,30,30,30,30,30,30,31,31,31,31,30,30,30,30,30,30,30,30,30,30,30,30,31,31,
        31,31,30,30,32,32,30,30,30,30,30,30,30,30,30,30,30,30,30,30,31,31,31,31,30,30,30,30,30,30,33,33,30,30,30,30,30,30,30,30,31,31,31,31,30,30,30,30,30,30,30,30,30,30,30,30,31,31,
        31,31,30,30,30,30,30,30,30,30,30,30,30,30,30,30,30,30,30,30,30,30,30,30,30,30,30,30,30,30,30,30,30,30,30,30,30,30,30,30,31,31,31,31,30,30,30,30,30,30,32,32,30,30,30,30,31,31,
        31,31,30,30,30,30,30,30,30,30,30,30,30,30,30,30,30,30,30,30,30,30,30,30,30,30,30,30,30,30,30,30,30,30,30,30,30,30,30,30,31,31,31,31,30,30,30,30,30,30,32,32,30,30,30,30,31,31,
        31,31,30,30,30,30,30,30,30,30,33,33,30,30,30,30,30,30,30,30,30,30,30,30,30,30,30,30,30,30,30,30,30,30,30,30,30,30,30,30,30,30,30,30,30,30,30,30,30,30,30,30,30,30,30,30,31,31,
        31,31,30,30,30,30,30,30,30,30,33,33,30,30,30,30,30,30,30,30,30,30,30,30,30,30,30,30,30,30,30,30,30,30,30,30,30,30,30,30,30,30,30,30,30,30,30,30,30,30,30,30,30,30,30,30,31,31,
        31,31,30,30,30,30,30,30,30,30,30,30,30,30,30,30,30,30,30,30,30,30,30,30,30,30,30,30,31,31,31,31,30,30,30,30,30,30,30,30,30,30,30,30,30,30,33,33,30,30,30,30,30,30,30,30,31,31,
        31,31,30,30,30,30,30,30,30,30,30,30,30,30,30,30,30,30,30,30,30,30,30,30,30,30,30,30,31,31,31,31,30,30,30,30,30,30,30,30,30,30,30,30,30,30,33,33,30,30,30,30,30,30,30,30,31,31,
        31,31,30,30,30,30,32,32,30,30,30,30,30,30,30,30,30,30,30,30,30,30,30,30,30,30,30,30,31,31,31,31,30,30,30,30,30,30,30,30,30,30,30,30,30,30,30,30,30,30,30,30,30,30,30,30,31,31,
        31,31,30,30,30,30,32,32,30,30,30,30,30,30,30,30,30,30,30,30,30,30,30,30,30,30,30,30,31,31,31,31,30,30,30,30,30,30,30,30,30,30,30,30,30,30,30,30,30,30,30,30,30,30,30,30,31,31,
        31,31,30,30,30,30,30,30,30,30,30,30,30,30,30,30,30,30,30,30,30,30,30,30,30,30,30,30,30,30,30,30,30,30,30,30,30,30,30,30,30,30,30,30,30,30,30,30,30,30,30,30,30,30,30,30,31,31,
        31,31,30,30,30,30,30,30,30,30,30,30,30,30,30,30,30,30,30,30,30,30,30,30,30,30,30,30,30,30,30,30,30,30,30,30,30,30,30,30,30,30,30,30,30,30,30,30,30,30,30,30,30,30,30,30,31,31,
        31,31,30,30,30,30,30,30,30,30,30,30,30,30,33,33,30,30,30,30,30,30,30,30,30,30,30,30,30,30,30,30,30,30,30,30,30,30,30,30,30,30,32,32,30,30,30,30,30,30,30,30,30,30,30,30,31,31,
        31,31,30,30,30,30,30,30,30,30,30,30,30,30,33,33,30,30,30,30,30,30,30,30,30,30,30,30,30,30,30,30,30,30,30,30,30,30,30,30,30,30,32,32,30,30,30,30,30,30,30,30,30,30,30,30,31,31,
        31,31,31,31,31,31,31,31,31,31,31,31,31,31,31,31,31,31,31,31,31,31,31,31,31,31,31,31,31,31,31,31,31,31,31,31,31,31,31,31,31,31,31,31,31,31,31,31,31,31,31,31,30,30,31,31,31,31,
        31,31,31,31,31,31,31,31,31,31,31,31,31,31,31,31,31,31,31,31,31,31,31,31,31,31,31,31,31,31,31,31,31,31,31,31,31,31,31,31,31,31,31,31,31,31,31,31,31,31,31,31,30,30,31,31,31,31
    ],
    "enemies": [
        {"id": "clown1", "type": "Carnival Clown", "x": 28, "y": 10, "hp": 20, "damage": 4, "disposition": -40, "flipThreshold": 30, "bribeable": true, "values": {"bandage": 6, "soap": 4, "rock": 3}, "behavior": ["IDLE", "WANDER"], "wanderRadius": 6, "wanderEveryTurns": 3, "adjacencyBark": "[Carnival Clown: HONK. You wanna play? You wanna PLAY?]"}
    ],
    "items": [
        {"type": "hot_dog", "x": 16, "y": 6},
        {"type": "bandage", "x": 40, "y": 16},
        {"type": "lion_whip", "x": 10, "y": 5}
    ],
    "examinables": [
        {"id": "booth", "x": 28, "y": 12, "text": "[A shuttered game booth — RING THE BOTTLE, WIN A PRIZE. The bottles are glued down. The tents stretch east as far as you can see.]"}
    ],
    "transitions": [
        {"x": 4, "y": 0, "toMap": "town-map.json", "toX": 16, "toY": 22, "label": "[North — back into Violencetown]"},
        {"x": 52, "y": 20, "toMap": "graveyard-map.json", "toX": 14, "toY": 2, "label": "[South — on through to the GRAVEYARD]"}
    ]
}
