{
    "width": 30,
    "height": 30,
    "spawn": {"x": 26, "y": 14},
    "zoneName": "FACTORY",
    "tiles": [
        41,41,41,41,41,41,41,41,41,41,41,41,41,41,41,41,41,41,41,41,41,41,41,41,41,41,41,41,41,41,
        41,41,41,41,41,41,41,41,41,41,41,41,41,41,41,41,41,41,41,41,41,41,41,41,41,41,41,41,41,41,
        41,41,40,40,40,40,40,40,41,41,41,41,41,41,40,40,40,40,40,40,41,41,41,41,41,41,40,40,41,41,
        41,41,40,40,40,40,40,40,41,41,41,41,41,41,40,40,40,40,40,40,41,41,41,41,41,41,40,40,41,41,
        41,41,40,40,40,40,40,40,40,40,40,40,40,40,40,40,40,40,40,40,40,40,40,40,40,40,40,40,41,41,
        41,41,40,40,40,40,40,40,40,40,40,40,40,40,40,40,40,40,40,40,40,40,40,40,40,40,40,40,41,41,
        41,41,40,40,42,42,40,40,40,40,40,40,43,43,43,43,43,43,40,40,40,40,40,40,40,40,40,40,41,41,
        41,41,40,40,42,42,40,40,40,40,40,40,43,43,43,43,43,43,40,40,40,40,40,40,40,40,40,40,41,41,
        41,41,40,40,42,42,40,40,40,40,40,40,43,43,43,43,43,43,40,40,40,40,40,40,40,40,40,40,41,41,
        41,41,40,40,42,42,40,40,40,40,40,40,43,43,43,43,43,43,40,40,40,40,40,40,40,40,40,40,41,41,
        41,41,40,40,40,40,40,40,41,41,40,40,40,40,40,40,40,40,40,40,41,41,40,40,42,42,42,42,41,41,
        41,41,40,40,40,40,40,40,41,41,40,40,40,40,40,40,40,40,40,40,41,41,40,40,42,42,42,42,41,41,
        41,41,40,40,40,40,40,40,41,41,40,40,40,40,40,40,40,40,40,40,41,41,40,40,42,42,42,42,41,41,
        41,41,40,40,40,40,40,40,41,41,40,40,40,40,40,40,40,40,40,40,41,41,40,40,42,42,42,42,41,41,
        41,41,40,40,40,40,40,40,40,40,40,40,40,40,40,40,40,40,40,40,40,40,40,40,40,40,40,40,40,40,
        41,41,40,40,40,40,40,40,40,40,40,40,40,40,40,40,40,40,40,40,40,40,40,40,40,40,40,40,40,40,
        41,41,40,40,40,40,40,40,41,41,40,40,40,40,40,40,40,40,40,40,41,41,40,40,42,42,42,42,41,41,
        41,41,40,40,40,40,40,40,41,41,40,40,40,40,40,40,40,40,40,40,41,41,40,40,42,42,42,42,41,41,
        41,41,40,40,40,40,40,40,41,41,40,40,40,40,40,40,40,40,40,40,41,41,40,40,40,40,40,40,41,41,
        41,41,40,40,40,40,40,40,41,41,40,40,40,40,40,40,40,40,40,40,41,41,40,40,40,40,40,40,41,41,
        41,41,40,40,42,42,40,40,40,40,40,40,43,43,43,43,43,43,40,40,40,40,40,40,40,40,40,40,41,41,
        41,41,40,40,42,42,40,40,40,40,40,40,43,43,43,43,43,43,40,40,40,40,40,40,40,40,40,40,41,41,
        41,41,40,40,42,42,40,40,40,40,40,40,43,43,43,43,43,43,40,40,40,40,40,40,40,40,40,40,41,41,
        41,41,40,40,42,42,40,40,40,40,40,40,43,43,43,43,43,43,40,40,40,40,40,40,40,40,40,40,41,41,
        41,41,40,40,40,40,40,40,40,40,40,40,40,40,40,40,40,40,40,40,40,40,40,40,40,40,40,40,41,41,
        41,41,40,40,40,40,40,40,40,40,40,40,40,40,40,40,40,40,40,40,40,40,40,40,40,40,40,40,41,41,
        41,41,40,40,40,40,40,40,41,41,41,41,41,41,40,40,40,40,40,40,41,41,41,41,41,41,40,40,41,41,
        41,41,40,40,40,40,40,40,41,41,41,41,41,41,40,40,40,40,40,40,41,41,41,41,41,41,40,40,41,41,
        41,41,41,41,41,41,41,41,41,41,41,41,41,41,41,41,41,41,41,41,41,41,41,41,41,41,41,41,41,41,
        41,41,41,41,41,41,41,41,41,41,41,41,41,41,41,41,41,41,41,41,41,41,41,41,41,41,41,41,41,41
    ],
    "enemies": [
        {"id": "green1", "type": "Greedy Green", "x": 14, "y": 14, "hp": 25, "damage": 5, "disposition": -50, "flipThreshold": 30, "bribeable": true, "values": {"rock": 5, "soap": 3, "bandage": 4}, "behavior": ["IDLE", "WANDER"], "wanderRadius": 4, "wanderEveryTurns": 3, "adjacencyBark": "[Greedy Green: BZZT — UNAUTHORIZED. THE GOO IS MINE.]"},
        {"id": "puck", "type": "Puck", "x": 8, "y": 14, "hp": 30, "damage": 1, "disposition": 60, "flipThreshold": 0, "bribeable": true, "vendor": true, "stock": ["bandage", "hot_dog", "boardwalk_burger", "soap", "rock", "sludge_sack", "pipe"], "values": {"rock": 1, "soap": 4, "bandage": 3, "hot_dog": 2}, "behavior": ["IDLE"], "adjacencyBark": "[Puck: Buyin'? Sellin'? Both, I'll bet — smart. Step up to the till — press E.]"}
    ],
    "items": [
        {"type": "rock", "x": 10, "y": 10},
        {"type": "rock", "x": 10, "y": 10}
    ],
    "transitions": [
        {"x": 28, "y": 14, "toMap": "town-map.json", "toX": 4, "toY": 12, "label": "[East — back out to the street]"}
    ]
}
