{
    "width": 30,
    "height": 30,
    "spawn": {"x": 14, "y": 2},
    "zoneName": "GRAVEYARD",
    "tiles": [
        53,53,53,53,53,53,53,53,53,53,53,53,53,53,50,50,53,53,53,53,53,53,53,53,53,53,53,53,53,53,
        53,53,53,53,53,53,53,53,53,53,53,53,53,53,50,50,53,53,53,53,53,53,53,53,53,53,53,53,53,53,
        53,53,52,52,51,51,52,52,52,52,51,51,52,52,52,52,51,51,52,52,52,52,51,51,52,52,52,52,53,53,
        53,53,52,52,51,51,52,52,52,52,51,51,52,52,52,52,51,51,52,52,52,52,51,51,52,52,52,52,53,53,
        53,53,52,52,52,52,52,52,52,52,52,52,52,52,52,52,52,52,52,52,52,52,52,52,52,52,52,52,53,53,
        53,53,52,52,52,52,52,52,52,52,52,52,52,52,52,52,52,52,52,52,52,52,52,52,52,52,52,52,53,53,
        53,53,52,52,51,51,52,52,52,52,51,51,52,52,52,52,51,51,52,52,52,52,51,51,52,52,52,52,53,53,
        53,53,52,52,51,51,52,52,52,52,51,51,52,52,52,52,51,51,52,52,52,52,51,51,52,52,52,52,53,53,
        53,53,52,52,52,52,52,52,52,52,52,52,52,52,52,52,52,52,52,52,52,52,52,52,52,52,52,52,53,53,
        53,53,52,52,52,52,52,52,52,52,52,52,52,52,52,52,52,52,52,52,52,52,52,52,52,52,52,52,53,53,
        53,53,52,52,51,51,52,52,52,52,51,51,52,52,52,52,51,51,52,52,52,52,51,51,52,52,52,52,53,53,
        53,53,52,52,51,51,52,52,52,52,51,51,52,52,52,52,51,51,52,52,52,52,51,51,52,52,52,52,53,53,
        53,53,52,52,52,52,52,52,52,52,52,52,52,52,52,52,52,52,52,52,52,52,52,52,52,52,52,52,53,53,
        53,53,52,52,52,52,52,52,52,52,52,52,52,52,52,52,52,52,52,52,52,52,52,52,52,52,52,52,53,53,
        53,53,52,52,51,51,52,52,52,52,51,51,52,52,50,50,50,50,51,51,52,52,52,52,51,51,52,52,53,53,
        53,53,52,52,51,51,52,52,52,52,51,51,52,52,50,50,50,50,51,51,52,52,52,52,51,51,52,52,53,53,
        53,53,52,52,52,52,52,52,52,52,52,52,50,50,50,50,50,50,52,52,52,52,52,52,52,52,52,52,53,53,
        53,53,52,52,52,52,52,52,52,52,52,52,50,50,50,50,50,50,52,52,52,52,52,52,52,52,52,52,53,53,
        53,53,52,52,51,51,52,52,52,52,51,51,52,52,50,50,50,50,51,51,52,52,52,52,51,51,52,52,53,53,
        53,53,52,52,51,51,52,52,52,52,51,51,52,52,50,50,50,50,51,51,52,52,52,52,51,51,52,52,53,53,
        53,53,52,52,52,52,52,52,52,52,52,52,52,52,52,52,52,52,52,52,52,52,52,52,52,52,52,52,53,53,
        53,53,52,52,52,52,52,52,52,52,52,52,52,52,52,52,52,52,52,52,52,52,52,52,52,52,52,52,53,53,
        53,53,52,52,51,51,52,52,52,52,51,51,52,52,52,52,51,51,52,52,52,52,51,51,52,52,52,52,53,53,
        53,53,52,52,51,51,52,52,52,52,51,51,52,52,52,52,51,51,52,52,52,52,51,51,52,52,52,52,53,53,
        53,53,52,52,52,52,52,52,52,52,52,52,52,52,50,50,52,52,52,52,52,52,52,52,52,52,52,52,53,53,
        53,53,52,52,52,52,52,52,52,52,52,52,52,52,50,50,52,52,52,52,52,52,52,52,52,52,52,52,53,53,
        53,53,53,53,53,53,53,53,53,53,53,53,53,53,50,50,53,53,53,53,53,53,53,53,53,53,53,53,53,53,
        53,53,53,53,53,53,53,53,53,53,53,53,53,53,50,50,53,53,53,53,53,53,53,53,53,53,53,53,53,53,
        53,53,53,53,53,53,53,53,53,53,53,53,53,53,53,53,53,53,53,53,53,53,53,53,53,53,53,53,53,53,
        53,53,53,53,53,53,53,53,53,53,53,53,53,53,53,53,53,53,53,53,53,53,53,53,53,53,53,53,53,53
    ],
    "enemies": [
        {"id": "skel1", "type": "Rattling Skeleton", "x": 14, "y": 14, "hp": 18, "damage": 4, "disposition": -40, "flipThreshold": 30, "bribeable": true, "values": {"bandage": 5, "rock": 4, "soap": 3}, "behavior": ["IDLE", "WANDER"], "wanderRadius": 4, "wanderEveryTurns": 3, "adjacencyBark": "[Skeleton: rattles disapprovingly]"}
    ],
    "items": [
        {"type": "soap", "x": 6, "y": 8},
        {"type": "fearmur", "x": 14, "y": 6}
    ],
    "transitions": [
        {"x": 14, "y": 0, "toMap": "circus-map.json", "toX": 52, "toY": 18, "label": "[North — back up to the Carnival]"},
        {"x": 14, "y": 26, "toMap": "wilderness-map.json", "toX": 8, "toY": 2, "label": "[South — toward the WILDERNESS. The dark out there is total.]"}
    ]
}
