{
    "width": 18,
    "height": 14,
    "spawn": {"x": 8, "y": 2},
    "zoneName": "WILDERNESS",
    "tiles": [
        53,53,53,53,53,53,53,53,52,52,53,53,53,53,53,53,53,53,
        53,53,53,53,53,53,53,53,52,52,53,53,53,53,53,53,53,53,
        53,53,52,52,52,52,52,52,52,52,52,52,52,52,52,52,53,53,
        53,53,52,52,52,52,52,52,52,52,52,52,52,52,52,52,53,53,
        53,53,52,52,52,52,52,52,52,52,52,52,52,52,52,52,53,53,
        53,53,52,52,52,52,52,52,52,52,52,52,52,52,52,52,53,53,
        53,53,52,52,52,52,52,52,52,52,52,52,52,52,52,52,53,53,
        53,53,52,52,52,52,52,52,52,52,52,52,52,52,52,52,53,53,
        53,53,52,52,52,52,52,52,52,52,52,52,52,52,52,52,53,53,
        53,53,52,52,52,52,52,52,52,52,52,52,52,52,52,52,53,53,
        53,53,52,52,52,52,52,52,52,52,52,52,52,52,52,52,53,53,
        53,53,52,52,52,52,52,52,52,52,52,52,52,52,52,52,53,53,
        53,53,53,53,53,53,53,53,53,53,53,53,53,53,53,53,53,53,
        53,53,53,53,53,53,53,53,53,53,53,53,53,53,53,53,53,53
    ],
    "enemies": [],
    "items": [],
    "examinables": [
        {"id": "dark", "x": 8, "y": 12, "text": "[Total black. The wilderness breathes somewhere out past the fence. Without a light — or the car — going further is just a slower way to die. Turn back.]"}
    ],
    "transitions": [
        {"x": 8, "y": 0, "toMap": "graveyard-map.json", "toX": 14, "toY": 24, "label": "[North — back to the graveyard's edge, and the light.]"}
    ]
}
